------------------------------------------------------9789878945645645612378912123445689
1234565788797897898789456456456123789123456456789789456879123789456789123789456123789456
1234562489456789123789456123789456789456789123789456123789
12345681--
12345657--P--------------------
12345624--Q----------
1234568145678--------------------------------------------------------------------E
78978456----5-----------------------6123789456789456787892123--------------------6------------------------------------123456789488795456241233
12345657-F--6-------------W---------4561237891234564567897894--------5------------------------------------------------789456456123456789789245
123456578879789789878945645645612---91----6456789789456879123---------------------------------------------------------89------------3789789456
1234562489456789123789456123789456789456--9123789456123789456---------------------------------------------------------12------------7895689456
-----------------------------471235612----------------------D-------------------------------------------------------R-12---T--------3789789456
-----------------------------471234545----------------------D-------------------------------------------456--456789456645678456-----3789789456
-----------------------------471238889---45645645-----------DDDDDDDDDDDDDDDDDDDDDDDDDDDDDDDDDDDDDDDDDDDDDDDDD4564561238-------------3789789456
-----------------------------471237578-----------89-------------------DD2------------------------------------4564561238-------------3789789456
-----------------------------471238956-------------23-------------------3------------------------------------4564561238--------456123789789456
--------------------------DDDDDDD-7823---------------12-----------------1------------------------------------4564561238----1234656123789789456
-----------------------------471234556-----------------56---------------5-----------------8------------------456-----------1232956123789789456
-----------------------------471234512DDDDDDDD---------56-------------DD5----------------123-----------------456456123812345678956123789789456
-----------------------------47123789789754561234567894567894679434123215645612385612384565612378978945645612456456123856123845656123789789456
-----------------------------47123789789754561234567894567894679434123215645612385612384565612378978945645612456456123856123845656123789789456
-----------------------------47123789789754561234567894567894679434123215645612385612384565612378978945645612456456123856123845656123789789456