5181651546543841684565466554616846134656557646746946544565645649622
651545-----------------94515----------------------------------689622
965545----------P------568524---------------------------------629625
665541--------Y--------651355------------------653724----------569623
582156--------996------546576------------------654433----------699625
346862----DDDDDDDDDDDDD853212DDDDDDDDDDDDD-----592515---DDDDDDD38962
566456-----------------146557------------------625435----------699627
545666-----------------426557---------------5--92863-----------999628
564566-----------------462575-----------5------618236----------649624
56845462---------------456357-------5----------553423----------299625
924454DDDDDDDDDDDDD----9154655---DDDDDDDDDDDDDD263612DDDDDDD---729625
614564-----------------655513------------------657323----------569626
564864-----------------465857--5---------------634343----------699624
618215-----------------655813-----5------5-----657392----------569624
566842-----------------465857DDDDDDDDDDDDDD---5651343----------699628
328122----DDDDDDDDDDDDD832851------------------923315---DDDDDDD389629
569125-----------------465857--------5----55---655343----------699627
566418-----------------465857----5-------------928383----------999628
566422-----------------465867----DDDDDDDDDDDDDD689323----------649629
566843-----------------4658675---5-------------661363----------299627
926846DDDDDDDDDDDDD----916885----5-------------233361DDDDDDD---769628
619128-----------------65183265--5------5------652372----------569625
566849-----------------465872DDDDDDDDDDDDDD---5655343----------699624
619218-----------------651831------------------658372----------569622
563517-----------------646857----------5----5--654393----------699625
329825----DDDDDDDDDDDDD283821----5-------------925315---DDDDDDD389623
566811-----------------486857----DDDDDDDDDDDDDD654343----------699625
568131-----------------946857------------------962383----------999625
566812-----------------462857-5----------------668323----------649625
56682182---------------466857-----5------5-----662363----------299626
923181DDDDDDDDDDDDD----912865DDDDDDDDDDDDDD---5232361DDDDDDD---729624
618132-----------------659813------------------657312----------569628
563583-----------------436857----------------5-651343----------699629
619218-----------------658813-----5------5-----657342----------569624
566827-----------------436857----DDDDDDDDDDDDDD659343----------699622
328137----DDDDDDDDDDDDD8328615-----------------928315---DDDDDDD389626
568948-----------------486857------------------655343----------699622
564969-----------------469857---5--------5-----926383----------999623
561656-----------------496857DDDDDDDDDDDDDD----682323----------649621
564565-----------------462587-----------------5681323----------299622
928346DDDDDDDDDDDDD----921865------------------567384DDDDDDD---729621
281355-----------------811823------65-------5--894323----------289622
286147---------------------------DDDDDDDDDDDDDD893323----------289621
285647-----------------------------------------892383----------289622
289128-----------------------23----------------892323--------F-289621
582359DDDDDDDDDDDDDDD15631DDDDDDDDDDDDDDDDDD656432523DDDDDDD623249622