1816515465438416845654665546168461346565576467469465445656456496218165154654384168456546655461684613465655764674694654456564564962181651546543841684565466554616846134656557646746946544565645649621245155644564456445644564468421381223
621545-------------------------D-----------------------D---------------------------------------------------------------------------------------------------------------2--------------------------------------5644---5-----5555---564443
936545----------P--------------D----------------D64248-D--------------------------------------------------D---------------------------------------222222---------------2--------------------------------------5644---5-----5--5---564443
636541-----------------------D------------D864121------D------------56962---------------------------------------4--------------------------4---------------------------2--------------------------------------5644---5-----555----564443
538216-----------------------D-D----D482156-------------------------69962---------4-----------------3-----------------------------333-------------------------------22222222--------4---------4-------2-----F-5644---55555-5555---564443
1381651546543841684565466554616846134656557646746946544565645649621816515DDDDDDDDDDDDDDDDDDDDDDDDDDDDDDDDDDDDDDDDDDDDDDDDDDDDDDDDDDDDDDDDDDDDDDDDDDDDDDDDDDDDDDDDDDDDDDDDDDDDDDDDDDDDDDDDDDDDDDDDDDDDDDDDD564456445644564444444564781353