18165154654384168456546655461684613465655764674694654456564564962181651522
613545--------------------------------------------------------------666822
963545----------P-------------------------------D64248-----63452----555552
6635416584241354534821------D2D------D864121---------------31512----569622
583216--343--F---67453-------------------------------------41341----699622
183165-546543841684565DDDDDDDDDDDDDDDDDDDDDDDDDDDDDDDDDDDDD45649----165152
433546---444856565------------------------------DDDDD------DDDDD----452152
16355165-651353515--D-3-----2-------------------DDDDD------DDDDD----165412
153615---165151561--D----------3----------------DDDDD------DDDDD----159662
563186-64465546165--D---------------3-----------DDDDD------DDDDD----159632
463548---446484848--D---------------------------DDDDD------DDDD-----186122
46384655-684648668--D------------------5-------------------DDDD-----423562
453684--------------D----------------------4---2DDDD-------DDDDD----468462
56348754164164564864DDDDDDDDDDDDDDDDDDDDDD76787786984894351684635468146842