1536151546543841684565466554616846134615465438416845654665546168461346154654384168456546655461684613465987189478924748582
153615--------DDDDDDD---------------------------------------------------------------------------------------------6786137
187874--P-----DDDDDDD------------------------------------------------------------------------------------------F--6712375
153615--------------D------2---D----------D----------D----------D----------D----------D----------D----------D578176372461
1536151234----------D----------D----------D----------D----------D----------D----------D----------D47611378462689177823856
153615DDD4----------D----------D----------D----------D----------D----------D----------D58172364736----------------6891723
153615DDD5----------D----------D----------D----------D----------D----------D57273646572---------------------------6891723
15361515467162379572DDDDDDDDDDDDDDDDDDDDDDDDDDDDDDDDDDDDDDDDDDDDDDDDDDDDDDDDDDDDDDDDDDDDDDDDDDDDDDDDDDDDDDDDDDDDDDDDDDDDD